111111111111111111111
100110000000000000001
100000011000P01000001
100110000000000000001
111111111111111111111