111111111111111111111
111100000000000011101
111100000000000011101
111100000000000011101
10000000000P000000001
100000000000000000001
100000000000000000001
111100000000000001111
111100000000000001111
111100000000000001111
111111111111111111111